"ID";"Periods";"PopulationAtStartOfSelectedPeriod_1";"LiveBirths_2";"Deaths_3";"Immigration_4";"EmigrationIncludingAdministrativeC_5";"NetCorrections_6";"TotalPopulationGrowth_7";"PopulationAtEndOfSelectedPeriod_8"
"0";"1995MM01";"15424122";"   16436";"   11974";"    8362";"    6768";"";"    6056";"15430178"
"1";"1995MM02";"15430178";"   14824";"   10106";"    6621";"    5341";"";"    5998";"15436176"
"2";"1995MM03";"15436176";"   16205";"   12069";"    7596";"    5988";"";"    5744";"15441920"
"3";"1995MM04";"15441920";"   14906";"   11412";"    6288";"    5490";"";"    4292";"15446212"
"4";"1995MM05";"15446212";"   16167";"   11180";"    6672";"    5501";"";"    6158";"15452370"
"5";"1995MM06";"15452370";"   16124";"   10508";"    7195";"    6335";"";"    6476";"15458846"
"6";"1995MM07";"15458846";"   16698";"   11288";"    8628";"    9069";"";"    4969";"15463815"
"7";"1995MM08";"15463815";"   16491";"   10928";"   10334";"    8177";"";"    7720";"15471535"
"8";"1995MM09";"15471535";"   16222";"   10199";"    9083";"    7842";"";"    7264";"15478799"
"9";"1995MM10";"15478799";"   16508";"   11030";"    9211";"    7579";"";"    7110";"15485909"
"10";"1995MM11";"15485909";"   15199";"   11234";"    8868";"    7469";"";"    5364";"15491273"
"11";"1995MM12";"15491273";"   14733";"   13747";"    7241";"    6636";"    1025";"    2616";"15493889"
"12";"1995JJ00";"15424122";"  190513";"  135675";"   96099";"   82195";"    1025";"   69767";"15493889"
"13";"1996MM01";"15493889";"   15272";"   13912";"    9296";"    7267";"";"    3389";"15497278"
"14";"1996MM02";"15497278";"   14972";"   12376";"    7617";"    7461";"";"    2752";"15500030"
"15";"1996MM03";"15500030";"   15531";"   12264";"    8162";"    8363";"";"    3066";"15503096"
"16";"1996MM04";"15503096";"   15090";"   11675";"    7770";"    7684";"";"    3501";"15506597"
"17";"1996MM05";"15506597";"   15901";"   11271";"    7955";"    7203";"";"    5382";"15511979"
"18";"1996MM06";"15511979";"   15567";"   10672";"    7964";"    6957";"";"    5902";"15517881"
"19";"1996MM07";"15517881";"   16561";"   10933";"   10402";"    8905";"";"    7125";"15525006"
"20";"1996MM08";"15525006";"   16680";"   10379";"   11502";"    8026";"";"    9777";"15534783"
"21";"1996MM09";"15534783";"   16430";"   10187";"   10967";"    9206";"";"    8004";"15542787"
"22";"1996MM10";"15542787";"   16412";"   10747";"   10690";"    7529";"";"    8826";"15551613"
"23";"1996MM11";"15551613";"   15508";"   10970";"    9084";"    6618";"";"    7004";"15558617"
"24";"1996MM12";"15558617";"   15597";"   12175";"    7340";"    6726";"    4454";"    8490";"15567107"
"25";"1996JJ00";"15493889";"  189521";"  137561";"  108749";"   91945";"    4454";"   73218";"15567107"
"26";"1997MM01";"15567107";"   16377";"   14200";"    9684";"    6962";"";"    4899";"15572006"
"27";"1997MM02";"15572006";"   15053";"   11676";"    7656";"    6090";"";"    4943";"15576949"
"28";"1997MM03";"15576949";"   15798";"   11258";"    7283";"    6468";"";"    5355";"15582304"
"29";"1997MM04";"15582304";"   16215";"   10872";"    8502";"    6881";"";"    6964";"15589268"
"30";"1997MM05";"15589268";"   16483";"   11148";"    7393";"    5465";"";"    7263";"15596531"
"31";"1997MM06";"15596531";"   16019";"   10690";"    8574";"    6702";"";"    7201";"15603732"
"32";"1997MM07";"15603732";"   17211";"   10684";"   10345";"    8244";"";"    8628";"15612360"
"33";"1997MM08";"15612360";"   16406";"   11658";"   11915";"    8224";"";"    8439";"15620799"
"34";"1997MM09";"15620799";"   16552";"   10178";"   12145";"    7685";"";"   10834";"15631633"
"35";"1997MM10";"15631633";"   15975";"   10981";"   10336";"    7060";"";"    8270";"15639903"
"36";"1997MM11";"15639903";"   14774";"   10773";"    8200";"    5661";"";"    6540";"15646443"
"37";"1997MM12";"15646443";"   15580";"   11665";"    7827";"    6531";"    2538";"    7749";"15654192"
"38";"1997JJ00";"15567107";"  192443";"  135783";"  109860";"   81973";"    2538";"   87085";"15654192"
"39";"1998MM01";"15654192";"   16398";"   11359";"   10327";"    6028";"";"    9338";"15663530"
"40";"1998MM02";"15663530";"   15179";"   10716";"    7953";"    5869";"";"    6547";"15670077"
"41";"1998MM03";"15670077";"   16508";"   12928";"    9135";"    7039";"";"    5676";"15675753"
"42";"1998MM04";"15675753";"   16139";"   12317";"    8223";"    6556";"";"    5489";"15681242"
"43";"1998MM05";"15681242";"   16337";"   11641";"    8073";"    5679";"";"    7090";"15688332"
"44";"1998MM06";"15688332";"   16138";"   10459";"    9605";"    7874";"";"    7410";"15695742"
"45";"1998MM07";"15695742";"   17805";"   10953";"   11427";"    9232";"";"    9047";"15704789"
"46";"1998MM08";"15704789";"   17543";"   10703";"   13245";"    6999";"";"   13086";"15717875"
"47";"1998MM09";"15717875";"   18137";"   10703";"   13584";"    7025";"";"   13993";"15731868"
"48";"1998MM10";"15731868";"   17222";"   11101";"   11350";"    5559";"";"   11912";"15743780"
"49";"1998MM11";"15743780";"   16008";"   11334";"   10082";"    5207";"";"    9549";"15753329"
"50";"1998MM12";"15753329";"   15994";"   13268";"    9403";"    6222";"     989";"    6896";"15760225"
"51";"1998JJ00";"15654192";"  199408";"  137482";"  122407";"   79289";"     989";"  106033";"15760225"
"52";"1999MM01";"15760225";"   16218";"   13145";"    9330";"    5948";"";"    6455";"15766680"
"53";"1999MM02";"15766680";"   15191";"   12334";"    8386";"    5209";"";"    6034";"15772714"
"54";"1999MM03";"15772714";"   16818";"   13153";"    9767";"    6847";"";"    6585";"15779299"
"55";"1999MM04";"15779299";"   16880";"   11289";"    8019";"    5674";"";"    7936";"15787235"
"56";"1999MM05";"15787235";"   16379";"   11374";"    7540";"    5113";"";"    7432";"15794667"
"57";"1999MM06";"15794667";"   16941";"   10914";"    9082";"    6885";"";"    8224";"15802891"
"58";"1999MM07";"15802891";"   17638";"   11299";"   11200";"    8137";"";"    9402";"15812293"
"59";"1999MM08";"15812293";"   17713";"   11284";"   13008";"    7402";"";"   12035";"15824328"
"60";"1999MM09";"15824328";"   17566";"   10694";"   13074";"    7425";"";"   12521";"15836849"
"61";"1999MM10";"15836849";"   16691";"   11077";"   10194";"    7093";"";"    8715";"15845564"
"62";"1999MM11";"15845564";"   15983";"   11104";"   10326";"    6742";"";"    8463";"15854027"
"63";"1999MM12";"15854027";"   16427";"   12820";"    9225";"    6304";"    3395";"    9923";"15863950"
"64";"1999JJ00";"15760225";"  200445";"  140487";"  119151";"   78779";"    3395";"  103725";"15863950"
"65";"2000MM01";"15863950";"   17068";"   14915";"   10035";"    6516";"";"    5672";"15869622"
"66";"2000MM02";"15869622";"   16606";"   11773";"   10249";"    5587";"";"    9495";"15879117"
"67";"2000MM03";"15879117";"   17445";"   11608";"    9964";"    6667";"";"    9134";"15888251"
"68";"2000MM04";"15888251";"   16625";"   11468";"    8491";"    5685";"";"    7963";"15896214"
"69";"2000MM05";"15896214";"   17513";"   11511";"    9970";"    5654";"";"   10318";"15906532"
"70";"2000MM06";"15906532";"   16773";"   11200";"   10135";"    6455";"";"    9253";"15915785"
"71";"2000MM07";"15915785";"   17694";"   11164";"   12269";"    8214";"";"   10585";"15926370"
"72";"2000MM08";"15926370";"   18315";"   10960";"   14833";"    7717";"";"   14471";"15940841"
"73";"2000MM09";"15940841";"   17736";"   10667";"   14015";"    7414";"";"   13670";"15954511"
"74";"2000MM10";"15954511";"   17155";"   11556";"   12611";"    6703";"";"   11507";"15966018"
"75";"2000MM11";"15966018";"   16996";"   11372";"   11939";"    6443";"";"   11120";"15977138"
"76";"2000MM12";"15977138";"   16693";"   12333";"    8339";"    5922";"    3160";"    9937";"15987075"
"77";"2000JJ00";"15863950";"  206619";"  140527";"  132850";"   78977";"    3160";"  123125";"15987075"
"78";"2001MM01";"15987075";"   17344";"   13102";"   11772";"    7920";"";"    8094";"15995169"
"79";"2001MM02";"15995169";"   15334";"   11115";"   10209";"    5773";"";"    8655";"16003824"
"80";"2001MM03";"16003824";"   16834";"   12572";"   10588";"    7217";"";"    7633";"16011457"
"81";"2001MM04";"16011457";"   15679";"   11557";"    9724";"    5601";"";"    8245";"16019702"
"82";"2001MM05";"16019702";"   17537";"   12059";"   10669";"    6187";"";"    9960";"16029662"
"83";"2001MM06";"16029662";"   17050";"   11420";"   10096";"    6883";"";"    8843";"16038505"
"84";"2001MM07";"16038505";"   17942";"   11185";"   12166";"    8440";"";"   10483";"16048988"
"85";"2001MM08";"16048988";"   17726";"   11113";"   14633";"    7970";"";"   13276";"16062264"
"86";"2001MM09";"16062264";"   17147";"   10706";"   13109";"    6472";"";"   13078";"16075342"
"87";"2001MM10";"16075342";"   17556";"   11523";"   12332";"    7226";"";"   11139";"16086481"
"88";"2001MM11";"16086481";"   16345";"   11391";"   10536";"    6256";"";"    9234";"16095715"
"89";"2001MM12";"16095715";"   16109";"   12634";"    7570";"    6621";"    5146";"    9570";"16105285"
"90";"2001JJ00";"15987075";"  202603";"  140377";"  133404";"   82566";"    5146";"  118210";"16105285"
"91";"2002MM01";"16105285";"   17019";"   13469";"   11366";"    7301";"";"    7615";"16112900"
"92";"2002MM02";"16112900";"   15448";"   11735";"    8950";"    6610";"";"    6053";"16118953"
"93";"2002MM03";"16118953";"   16792";"   13281";"    9508";"    7847";"";"    5172";"16124125"
"94";"2002MM04";"16124125";"   15995";"   11968";"    9266";"    7172";"";"    6121";"16130246"
"95";"2002MM05";"16130246";"   16800";"   11623";"    8897";"    7513";"";"    6561";"16136807"
"96";"2002MM06";"16136807";"   16116";"   11084";"    8832";"    8162";"";"    5702";"16142509"
"97";"2002MM07";"16142509";"   18011";"   11509";"   11365";"    9981";"";"    7886";"16150395"
"98";"2002MM08";"16150395";"   17959";"   11134";"   13462";"    9500";"";"   10787";"16161182"
"99";"2002MM09";"16161182";"   17586";"   10438";"   13042";"    9135";"";"   11055";"16172237"
"100";"2002MM10";"16172237";"   17831";"   11530";"   11594";"    9107";"";"    8788";"16181025"
"101";"2002MM11";"16181025";"   16011";"   11491";"    8188";"    7270";"";"    5438";"16186463"
"102";"2002MM12";"16186463";"   16515";"   13093";"    6780";"    7320";"    3227";"    6109";"16192572"
"103";"2002JJ00";"16105285";"  202083";"  142355";"  121250";"   96918";"    3227";"   87287";"16192572"
"104";"2003MM01";"16192572";"   17153";"   13106";"    9483";"    8390";"";"    5140";"16197712"
"105";"2003MM02";"16197712";"   15579";"   11305";"    8169";"    7694";"";"    4749";"16202461"
"106";"2003MM03";"16202461";"   16755";"   13113";"    7939";"    7946";"";"    3635";"16206096"
"107";"2003MM04";"16206096";"   16585";"   12203";"    7363";"    7440";"";"    4305";"16210401"
"108";"2003MM05";"16210401";"   16572";"   11309";"    7160";"    6618";"";"    5805";"16216206"
"109";"2003MM06";"16216206";"   16325";"   11088";"    7595";"    8572";"";"    4260";"16220466"
"110";"2003MM07";"16220466";"   17913";"   11234";"    9396";"   12206";"";"    3869";"16224335"
"111";"2003MM08";"16224335";"   17572";"   11619";"   11276";"    9904";"";"    7325";"16231660"
"112";"2003MM09";"16231660";"   17338";"   10942";"   12441";"    9557";"";"    9280";"16240940"
"113";"2003MM10";"16240940";"   17087";"   11445";"   10097";"    9517";"";"    6222";"16247162"
"114";"2003MM11";"16247162";"   15864";"   11291";"    7197";"    8498";"";"    3272";"16250434"
"115";"2003MM12";"16250434";"   15554";"   13281";"    6398";"    8489";"    7416";"    7598";"16258032"
"116";"2003JJ00";"16192572";"  200297";"  141936";"  104514";"  104831";"    7416";"   65460";"16258032"
"117";"2004MM01";"16258032";"   16229";"   13726";"    7690";"    8848";"";"    1345";"16259377"
"118";"2004MM02";"16259377";"   15180";"   11300";"    6656";"    8636";"";"    1900";"16261277"
"119";"2004MM03";"16261277";"   16215";"   11983";"    7224";"    9976";"";"    1480";"16262757"
"120";"2004MM04";"16262757";"   15801";"   11092";"    5678";"    8915";"";"    1472";"16264229"
"121";"2004MM05";"16264229";"   15751";"   11093";"    6318";"    7153";"";"    3823";"16268052"
"122";"2004MM06";"16268052";"   16477";"   10692";"    7756";"    9087";"";"    4454";"16272506"
"123";"2004MM07";"16272506";"   17324";"   10786";"    8250";"   11431";"";"    3357";"16275863"
"124";"2004MM08";"16275863";"   16919";"   11166";"   10778";"   11138";"";"    5393";"16281256"
"125";"2004MM09";"16281256";"   16438";"   10553";"   11967";"    9523";"";"    8329";"16289585"
"126";"2004MM10";"16289585";"   16239";"   11103";"    8556";"    9540";"";"    4152";"16293737"
"127";"2004MM11";"16293737";"   15613";"   10969";"    7095";"    7697";"";"    4042";"16297779"
"128";"2004MM12";"16297779";"   15821";"   12090";"    6051";"    8291";"    6256";"    7747";"16305526"
"129";"2004JJ00";"16258032";"  194007";"  136553";"   94019";"  110235";"    6256";"   47494";"16305526"
"130";"2005MM01";"16305526";"   15678";"   12544";"    6935";"    8618";"";"    1451";"16306977"
"131";"2005MM02";"16306977";"   14671";"   12264";"    6844";"    8340";"";"     911";"16307888"
"132";"2005MM03";"16307888";"   15876";"   13783";"    6847";"    9346";"";"    -406";"16307482"
"133";"2005MM04";"16307482";"   15563";"   11214";"    6339";"    9301";"";"    1387";"16308869"
"134";"2005MM05";"16308869";"   15711";"   11453";"    5699";"    7807";"";"    2150";"16311019"
"135";"2005MM06";"16311019";"   15583";"   10883";"    6589";"    9712";"";"    1577";"16312596"
"136";"2005MM07";"16312596";"   16405";"   10381";"    7576";"   10958";"";"    2642";"16315238"
"137";"2005MM08";"16315238";"   16701";"   10348";"   10263";"   12343";"";"    4273";"16319511"
"138";"2005MM09";"16319511";"   16194";"   10024";"   12965";"   11071";"";"    8064";"16327575"
"139";"2005MM10";"16327575";"   16024";"   10805";"    8457";"   10433";"";"    3243";"16330818"
"140";"2005MM11";"16330818";"   14728";"   10796";"    7528";"   10348";"";"    1112";"16331930"
"141";"2005MM12";"16331930";"   14776";"   11907";"    6255";"   11448";"    4604";"    2280";"16334210"
"142";"2005JJ00";"16305526";"  187910";"  136402";"   92297";"  119725";"    4604";"   28684";"16334210"
"143";"2006MM01";"16334210";"   15399";"   12261";"    7426";"   10059";"";"     505";"16334715"
"144";"2006MM02";"16334715";"   14286";"   11377";"    7450";"    9615";"";"     744";"16335459"
"145";"2006MM03";"16335459";"   15646";"   12689";"    7757";"   12083";"";"   -1369";"16334090"
"146";"2006MM04";"16334090";"   14543";"   11474";"    6466";"   10066";"";"    -531";"16333559"
"147";"2006MM05";"16333559";"   15673";"   10992";"    7221";"   10861";"";"    1041";"16334600"
"148";"2006MM06";"16334600";"   15171";"   10764";"    7338";"    9669";"";"    2076";"16336676"
"149";"2006MM07";"16336676";"   15999";"   12164";"    8614";"   11872";"";"     577";"16337253"
"150";"2006MM08";"16337253";"   16262";"   10409";"   11694";"   12467";"";"    5080";"16342333"
"151";"2006MM09";"16342333";"   16123";"   10398";"   13733";"   12874";"";"    6584";"16348917"
"152";"2006MM10";"16348917";"   16144";"   10349";"    9631";"   11665";"";"    3761";"16352678"
"153";"2006MM11";"16352678";"   15005";"   10865";"    7782";"   11628";"";"     294";"16352972"
"154";"2006MM12";"16352972";"   14806";"   11630";"    6038";"    9611";"    5417";"    5020";"16357992"
"155";"2006JJ00";"16334210";"  185057";"  135372";"  101150";"  132470";"    5417";"   23782";"16357992"
"156";"2007MM01";"16357992";"   15019";"   12221";"    9313";"   10970";"";"    1141";"16359133"
"157";"2007MM02";"16359133";"   13909";"   10884";"    8648";"    7868";"";"    3805";"16362938"
"158";"2007MM03";"16362938";"   15211";"   12019";"    8257";"    9322";"";"    2127";"16365065"
"159";"2007MM04";"16365065";"   14385";"   11021";"    7045";"    7878";"";"    2531";"16367596"
"160";"2007MM05";"16367596";"   15144";"   10799";"    8044";"    8707";"";"    3682";"16371278"
"161";"2007MM06";"16371278";"   14659";"   10423";"    8644";"    9617";"";"    3263";"16374541"
"162";"2007MM07";"16374541";"   15989";"   10484";"   10685";"   13392";"";"    2798";"16377339"
"163";"2007MM08";"16377339";"   16262";"   10450";"   13270";"   13146";"";"    5936";"16383275"
"164";"2007MM09";"16383275";"   16021";"    9906";"   14779";"   10326";"";"   10568";"16393843"
"165";"2007MM10";"16393843";"   15662";"   11049";"   11874";"   11191";"";"    5296";"16399139"
"166";"2007MM11";"16399139";"   14531";"   11281";"    9360";"   10740";"";"    1870";"16401009"
"167";"2007MM12";"16401009";"   14544";"   12485";"    6900";"    9419";"    4850";"    4390";"16405399"
"168";"2007JJ00";"16357992";"  181336";"  133022";"  116819";"  122576";"    4850";"   47407";"16405399"
"169";"2008MM01";"16405399";"   15071";"   12849";"   11236";"    9751";"";"    3707";"16409106"
"170";"2008MM02";"16409106";"   14236";"   11380";"   10954";"    8609";"";"    5201";"16414307"
"171";"2008MM03";"16414307";"   14771";"   12079";"    9580";"    8524";"";"    3748";"16418055"
"172";"2008MM04";"16418055";"   14804";"   11366";"   10337";"    8493";"";"    5282";"16423337"
"173";"2008MM05";"16423337";"   15597";"   11328";"    8961";"    7881";"";"    5349";"16428686"
"174";"2008MM06";"16428686";"   15418";"   10444";"   10372";"    9097";"";"    6249";"16434935"
"175";"2008MM07";"16434935";"   16903";"   10854";"   12782";"   13314";"";"    5517";"16440452"
"176";"2008MM08";"16440452";"   16350";"   10434";"   15119";"   12395";"";"    8640";"16449092"
"177";"2008MM09";"16449092";"   16393";"   10137";"   19940";"   10429";"";"   15767";"16464859"
"178";"2008MM10";"16464859";"   15685";"   10992";"   13957";"    9800";"";"    8850";"16473709"
"179";"2008MM11";"16473709";"   14556";"   10906";"   10849";"    8917";"";"    5582";"16479291"
"180";"2008MM12";"16479291";"   14850";"   12367";"    9429";"   10569";"    5153";"    6496";"16485787"
"181";"2008JJ00";"16405399";"  184634";"  135136";"  143516";"  117779";"    5153";"   80388";"16485787"
"182";"2009MM01";"16485787";"   15391";"   14371";"   11816";"    9581";"";"    3255";"16489042"
"183";"2009MM02";"16489042";"   13704";"   11695";"   11329";"    7149";"";"    6189";"16495231"
"184";"2009MM03";"16495231";"   15409";"   11546";"   11334";"    8745";"";"    6452";"16501683"
"185";"2009MM04";"16501683";"   15098";"   10922";"    9898";"    8975";"";"    5099";"16506782"
"186";"2009MM05";"16506782";"   15254";"   10670";"    8961";"    6712";"";"    6833";"16513615"
"187";"2009MM06";"16513615";"   15522";"   10254";"   10783";"    9005";"";"    7046";"16520661"
"188";"2009MM07";"16520661";"   16669";"   10573";"   13149";"   11506";"";"    7739";"16528400"
"189";"2009MM08";"16528400";"   16238";"   10239";"   16244";"   12101";"";"   10142";"16538542"
"190";"2009MM09";"16538542";"   16246";"   10253";"   20067";"   10006";"";"   16054";"16554596"
"191";"2009MM10";"16554596";"   15424";"   11176";"   13601";"   10128";"";"    7721";"16562317"
"192";"2009MM11";"16562317";"   14952";"   10719";"   10573";"    8624";"";"    6182";"16568499"
"193";"2009MM12";"16568499";"   15008";"   11817";"    8623";"    9365";"    4041";"    6490";"16574989"
"194";"2009JJ00";"16485787";"  184915";"  134235";"  146378";"  111897";"    4041";"   89202";"16574989"
"195";"2010MM01";"16574989";"   14929";"   12487";"   10962";"    9789";"";"    3615";"16578604"
"196";"2010MM02";"16578604";"   13905";"   11519";"   11911";"    7734";"";"    6563";"16585167"
"197";"2010MM03";"16585167";"   14994";"   12025";"   11677";"   10866";"";"    3780";"16588947"
"198";"2010MM04";"16588947";"   14753";"   10976";"    9679";"    8430";"";"    5026";"16593973"
"199";"2010MM05";"16593973";"   15031";"   11276";"    9116";"    7511";"";"    5360";"16599333"
"200";"2010MM06";"16599333";"   15386";"   10657";"   11394";"    9321";"";"    6802";"16606135"
"201";"2010MM07";"16606135";"   16160";"   11141";"   13240";"   12719";"";"    5540";"16611675"
"202";"2010MM08";"16611675";"   16116";"   10423";"   18983";"   12136";"";"   12540";"16624215"
"203";"2010MM09";"16624215";"   16219";"   10640";"   21545";"   12534";"";"   14590";"16638805"
"204";"2010MM10";"16638805";"   16064";"   11426";"   14360";"    9535";"";"    9463";"16648268"
"205";"2010MM11";"16648268";"   15436";"   10948";"   11839";"   10476";"";"    5851";"16654119"
"206";"2010MM12";"16654119";"   15404";"   12540";"    9726";"   10300";"    -610";"    1680";"16655799"
"207";"2010JJ00";"16574989";"  184397";"  136058";"  154432";"  121351";"    -610";"   80810";"16655799"
"208";"2011MM01";"16655799";"   15112";"   12200";"   12347";"    9916";"";"    5343";"16661142"
"209";"2011MM02";"16661142";"   14119";"   10644";"   12624";"    8229";"";"    7870";"16669012"
"210";"2011MM03";"16669012";"   14775";"   12044";"   11918";"    9730";"";"    4919";"16673931"
"211";"2011MM04";"16673931";"   14289";"   11338";"   10028";"   10005";"";"    2974";"16676905"
"212";"2011MM05";"16676905";"   15121";"   11292";"   10228";"    9449";"";"    4608";"16681513"
"213";"2011MM06";"16681513";"   15371";"   10612";"   11026";"   10748";"";"    5037";"16686550"
"214";"2011MM07";"16686550";"   15782";"   10995";"   13878";"   14635";"";"    4030";"16690580"
"215";"2011MM08";"16690580";"   16104";"   10686";"   22165";"   14691";"";"   12892";"16703472"
"216";"2011MM09";"16703472";"   15674";"   10635";"   23533";"   12966";"";"   15606";"16719078"
"217";"2011MM10";"16719078";"   15105";"   11285";"   13445";"   11015";"";"    6250";"16725328"
"218";"2011MM11";"16725328";"   14223";"   11475";"   12164";"   10566";"";"    4346";"16729674"
"219";"2011MM12";"16729674";"   14385";"   12535";"    9606";"   11244";"     462";"     674";"16730348"
"220";"2011JJ00";"16655799";"  180060";"  135741";"  162962";"  133194";"     462";"   74549";"16730348"
"221";"2012MM01";"16730348";"   14558";"   12490";"   12177";"   13313";"";"     932";"16731280"
"222";"2012MM02";"16731280";"   13804";"   12511";"   13142";"   10025";"";"    4410";"16735690"
"223";"2012MM03";"16735690";"   14672";"   12799";"   11210";"   11142";"";"    1941";"16737631"
"224";"2012MM04";"16737631";"   14244";"   11876";"    9485";"    9720";"";"    2133";"16739764"
"225";"2012MM05";"16739764";"   15089";"   11602";"   10082";"   10503";"";"    3066";"16742830"
"226";"2012MM06";"16742830";"   14580";"   11062";"   10680";"   12332";"";"    1866";"16744696"
"227";"2012MM07";"16744696";"   15218";"   11055";"   13579";"   15880";"";"    1862";"16746558"
"228";"2012MM08";"16746558";"   15696";"   10855";"   21709";"   14941";"";"   11609";"16758167"
"229";"2012MM09";"16758167";"   15129";"   10704";"   22205";"   12187";"";"   14443";"16772610"
"230";"2012MM10";"16772610";"   15110";"   11510";"   14687";"   12171";"";"    6116";"16778726"
"231";"2012MM11";"16778726";"   14204";"   11663";"   11222";"   11112";"";"    2651";"16781377"
"232";"2012MM12";"16781377";"   13655";"   12686";"    8196";"   11165";"     198";"   -1802";"16779575"
"233";"2012JJ00";"16730348";"  175959";"  140813";"  158374";"  144491";"     198";"   49227";"16779575"
"234";"2013MM01";"16779575";"   14534";"   13516";"   12794";"   12020";"";"    1792";"16781367"
"235";"2013MM02";"16781367";"   12746";"   12539";"   12627";"   10331";"";"    2503";"16783870"
"236";"2013MM03";"16783870";"   14074";"   13811";"   11080";"   10227";"";"    1116";"16784986"
"237";"2013MM04";"16784986";"   13699";"   12354";"   10425";"   10973";"";"     797";"16785783"
"238";"2013MM05";"16785783";"   14184";"   11441";"   10865";"   10399";"";"    3209";"16788992"
"239";"2013MM06";"16788992";"   14110";"   10814";"   10771";"   10937";"";"    3130";"16792122"
"240";"2013MM07";"16792122";"   15820";"   11261";"   14771";"   16163";"";"    3167";"16795289"
"241";"2013MM08";"16795289";"   15362";"   10788";"   20993";"   14977";"";"   10590";"16805879"
"242";"2013MM09";"16805879";"   14993";"   10326";"   23882";"   14352";"";"   14197";"16820076"
"243";"2013MM10";"16820076";"   14437";"   11490";"   14825";"   12086";"";"    5686";"16825762"
"244";"2013MM11";"16825762";"   13694";"   11029";"   11648";"   10823";"";"    3490";"16829252"
"245";"2013MM12";"16829252";"   13688";"   11876";"   10091";"   12381";"     515";"      37";"16829289"
"246";"2013JJ00";"16779575";"  171341";"  141245";"  164772";"  145669";"     515";"   49714";"16829289"
"247";"2014MM01";"16829289";"   14366";"   12198";"   14976";"   12514";"";"    4630";"16833919"
"248";"2014MM02";"16833919";"   13267";"   11142";"   14472";"   10217";"";"    6380";"16840299"
"249";"2014MM03";"16840299";"   14409";"   12008";"   12254";"    9974";"";"    4681";"16844980"
"250";"2014MM04";"16844980";"   14031";"   11258";"   12257";"   10537";"";"    4493";"16849473"
"251";"2014MM05";"16849473";"   14584";"   11367";"   10767";"    9720";"";"    4264";"16853737"
"252";"2014MM06";"16853737";"   14626";"   10596";"   12275";"   12231";"";"    4074";"16857811"
"253";"2014MM07";"16857811";"   15669";"   11721";"   14845";"   16745";"";"    2048";"16859859"
"254";"2014MM08";"16859859";"   15460";"   11199";"   21939";"   15208";"";"   10992";"16870851"
"255";"2014MM09";"16870851";"   15552";"   10972";"   26740";"   14716";"";"   16604";"16887455"
"256";"2014MM10";"16887455";"   15220";"   11635";"   16974";"   12994";"";"    7565";"16895020"
"257";"2014MM11";"16895020";"   13907";"   11725";"   12956";"   10000";"";"    5138";"16900158"
"258";"2014MM12";"16900158";"   14090";"   13402";"   12494";"   13006";"     392";"     568";"16900726"
"259";"2014JJ00";"16829289";"  175181";"  139223";"  182949";"  147862";"     392";"   71437";"16900726"
"260";"2015MM01";"16900726";"   14176";"   14955";"   16024";"   13216";"";"    2029";"16902755"
"261";"2015MM02";"16902755";"   12523";"   13183";"   15306";"   10141";"";"    4505";"16907260"
"262";"2015MM03";"16907260";"   13597";"   13673";"   13989";"   11238";"";"    2675";"16909935"
"263";"2015MM04";"16909935";"   13241";"   12195";"   12792";"   10547";"";"    3291";"16913226"
"264";"2015MM05";"16913226";"   14345";"   11811";"   10697";"    9583";"";"    3648";"16916874"
"265";"2015MM06";"16916874";"   14273";"   11138";"   14257";"   13352";"";"    4040";"16920914"
"266";"2015MM07";"16920914";"   15308";"   11590";"   17251";"   17780";"";"    3189";"16924103"
"267";"2015MM08";"16924103";"   15353";"   11174";"   25795";"   15966";"";"   14008";"16938111"
"268";"2015MM09";"16938111";"   15330";"   11250";"   29016";"   13736";"";"   19360";"16957471"
"269";"2015MM10";"16957471";"   14610";"   12235";"   18968";"   11770";"";"    9573";"16967044"
"270";"2015MM11";"16967044";"   13852";"   11612";"   16009";"    9828";"";"    8421";"16975465"
"271";"2015MM12";"16975465";"   13902";"   12318";"   14511";"   12352";"     -88";"    3655";"16979120"
"272";"2015JJ00";"16900726";"  170510";"  147134";"  204615";"  149509";"     -88";"   78394";"16979120"
"273";"2016MM01";"16979120";"   13990";"   13769";"   17415";"   13076";"";"    4560";"16983680"
"274";"2016MM02";"16983680";"   13342";"   12927";"   19595";"   11680";"";"    8330";"16992010"
"275";"2016MM03";"16992010";"   14107";"   13697";"   16507";"   11010";"";"    5907";"16997917"
"276";"2016MM04";"16997917";"   13823";"   12228";"   14517";"   10498";"";"    5614";"17003531"
"277";"2016MM05";"17003531";"   14513";"   12223";"   15047";"    9577";"";"    7760";"17011291"
"278";"2016MM06";"17011291";"   14539";"   11237";"   16662";"   13205";"";"    6759";"17018050"
"279";"2016MM07";"17018050";"   15683";"   11707";"   17362";"   16714";"";"    4624";"17022674"
"280";"2016MM08";"17022674";"   15603";"   11407";"   31452";"   15780";"";"   19868";"17042542"
"281";"2016MM09";"17042542";"   15163";"   11270";"   30085";"   14031";"";"   19947";"17062489"
"282";"2016MM10";"17062489";"   14539";"   12398";"   19489";"   12075";"";"    9555";"17072044"
"283";"2016MM11";"17072044";"   13529";"   12333";"   17757";"   11210";"";"    7743";"17079787"
"284";"2016MM12";"17079787";"   13689";"   13801";"   14851";"   12689";"    -330";"    1720";"17081507"
"285";"2016JJ00";"16979120";"  172520";"  148997";"  230739";"  151545";"    -330";"  102387";"17081507"
"286";"2017MM01";"17081507";"   14100";"   15814";"   17385";"   13395";"";"    2276";"17083783"
"287";"2017MM02";"17083783";"   12575";"   13642";"   19712";"   10972";"";"    7673";"17091456"
"288";"2017MM03";"17091456";"   13696";"   13037";"   17306";"   10586";"";"    7379";"17098835"
"289";"2017MM04";"17098835";"   13413";"   11799";"   13793";"    9282";"";"    6125";"17104960"
"290";"2017MM05";"17104960";"   14367";"   12331";"   15738";"   11145";"";"    6629";"17111589"
"291";"2017MM06";"17111589";"   14012";"   11398";"   16234";"   13569";"";"    5279";"17116868"
"292";"2017MM07";"17116868";"   15043";"   11535";"   18270";"   17811";"";"    3967";"17120835"
"293";"2017MM08";"17120835";"   15459";"   11396";"   32258";"   16295";"";"   20026";"17140861"
"294";"2017MM09";"17140861";"   14825";"   11387";"   32162";"   14150";"";"   21450";"17162311"
"295";"2017MM10";"17162311";"   14635";"   11888";"   20866";"   13021";"";"   10592";"17172903"
"296";"2017MM11";"17172903";"   13998";"   12247";"   17489";"   11453";"";"    7787";"17180690"
"297";"2017MM12";"17180690";"   13713";"   13740";"   13744";"   12613";"    -710";"     394";"17181084"
"298";"2017JJ00";"17081507";"  169836";"  150214";"  234957";"  154292";"    -710";"   99577";"17181084"
"299";"2018MM01";"17181084";"   14111";"   14857";"   18447";"   13308";"";"    4393";"17185477"
"300";"2018MM02";"17185477";"   12269";"   14454";"   19829";"   10815";"";"    6829";"17192306"
"301";"2018MM03";"17192306";"   13415";"   16332";"   15685";"   11972";"";"     796";"17193102"
"302";"2018MM04";"17193102";"   13417";"   12155";"   15006";"   10470";"";"    5798";"17198900"
"303";"2018MM05";"17198900";"   14619";"   11812";"   16270";"    9997";"";"    9080";"17207980"
"304";"2018MM06";"17207980";"   14192";"   11248";"   16062";"   13872";"";"    5134";"17213114"
"305";"2018MM07";"17213114";"   15297";"   12014";"   20006";"   18805";"";"    4484";"17217598"
"306";"2018MM08";"17217598";"   15132";"   11755";"   34642";"   17387";"";"   20632";"17238230"
"307";"2018MM09";"17238230";"   14955";"   11236";"   31674";"   13826";"";"   21567";"17259797"
"308";"2018MM10";"17259797";"   14424";"   12189";"   22544";"   13345";"";"   11434";"17271231"
"309";"2018MM11";"17271231";"   13581";"   12139";"   19157";"   11250";"";"    9349";"17280580"
"310";"2018MM12";"17280580";"   13113";"   13172";"   14415";"   12319";"    -454";"    1583";"17282163"
"311";"2018JJ00";"17181084";"  168525";"  153363";"  243737";"  157366";"    -454";"  101079";"17282163"
"312";"2019MM01";"17282163";"   14192";"   13998";"   21543";"   13880";"";"    7857";"17290020"
"313";"2019MM02";"17290020";"   12149";"   12758";"   21595";"   11663";"";"    9323";"17299343"
"314";"2019MM03";"17299343";"   13549";"   13757";"   18260";"   11696";"";"    6356";"17305699"
"315";"2019MM04";"17305699";"   13717";"   12593";"   17536";"   10968";"";"    7692";"17313391"
"316";"2019MM05";"17313391";"   14349";"   12426";"   17423";"   10747";"";"    8599";"17321990"
"317";"2019MM06";"17321990";"   14233";"   11683";"   17055";"   13610";"";"    5995";"17327985"
"318";"2019MM07";"17327985";"   15476";"   12314";"   23043";"   19039";"";"    7166";"17335151"
"319";"2019MM08";"17335151";"   15442";"   11773";"   37265";"   16733";"";"   24201";"17359352"
"320";"2019MM09";"17359352";"   15132";"   11267";"   36754";"   14594";"";"   26025";"17385377"
"321";"2019MM10";"17385377";"   14709";"   12571";"   24846";"   12997";"";"   13987";"17399364"
"322";"2019MM11";"17399364";"   13686";"   13017";"   18555";"   11426";"";"    7798";"17407162"
"323";"2019MM12";"17407162";"   13046";"   13728";"   15189";"   13676";"    -408";"     423";"17407585"
"324";"2019JJ00";"17282163";"  169680";"  151885";"  269064";"  161029";"    -408";"  125422";"17407585"
"325";"2020MM01";"17407585";"   14085";"   14111";"   22220";"   15808";"";"    6386";"17413971"
"326";"2020MM02";"17413971";"   12905";"   12895";"   21695";"   11813";"";"    9892";"17423863"
"327";"2020MM03";"17423863";"   13556";"   16237";"   15610";"   12535";"";"     394";"17424257"
"328";"2020MM04";"17424257";"   13375";"   18876";"    9365";"    8469";"";"   -4605";"17419652"
"329";"2020MM05";"17419652";"   13791";"   12641";"    9066";"    8063";"";"    2153";"17421805"
"330";"2020MM06";"17421805";"   13928";"   11478";"   12740";"   11197";"";"    3993";"17425798"
"331";"2020MM07";"17425798";"   15625";"   11627";"   18042";"   16918";"";"    5122";"17430920"
"332";"2020MM08";"17430920";"   15110";"   12568";"   26747";"   15385";"";"   13904";"17444824"
"333";"2020MM09";"17444824";"   14966";"   11905";"   30408";"   12997";"";"   20472";"17465296"
"334";"2020MM10";"17465296";"   14508";"   14613";"   20861";"   13612";"";"    7144";"17472440"
"335";"2020MM11";"17472440";"   13555";"   14925";"   17783";"   12371";"";"    4042";"17476482"
"336";"2020MM12";"17476482";"   13277";"   16802";"   16316";"   13326";"    -532";"   -1067";"17475415"
"337";"2020JJ00";"17407585";"  168681";"  168678";"  220853";"  152494";"    -532";"   67830";"17475415"
"338";"2021MM01";"17475415";"   13953";"   17307";"   15776";"   11782";"       0";"     640";"17476055"
"339";"2021MM02";"17476055";"   13480";"   13942";"   16245";"    9474";"       0";"    6309";"17482364"
"340";"2021MM03";"17482364";"   14905";"   13797";"   16466";"   11269";"       0";"    6305";"17488669"
"341";"2021MM04";"17488669";"   14517";"   13533";"   14827";"    9767";"       0";"    6044";"17494713"
"342";"2021MM05";"17494713";"   14806";"   13124";"   13927";"    9358";"       0";"    6251";"17500964"
"343";"2021MM06";"17500964";"   14833";"   12205";"   16402";"   12092";"       0";"    6938";"17507902"
"344";"2021MM07";"17507902";"   16108";"   12607";"   19989";"   15516";"       0";"    7974";"17515876"
"345";"2021MM08";"17515876";"   15958";"   12769";"   34635";"   15918";"       0";"   21906";"17537782"
"346";"2021MM09";"17537782";"   16225";"   12709";"   40109";"   13118";"       0";"   30507";"17568289"
"347";"2021MM10";"17568289";"   15713";"   14150";"   24873";"   12060";"       0";"   14376";"17582665"
"348";"2021MM11";"17582665";"   14676";"   16782";"   21646";"   11160";"       0";"    8380";"17591045"
"349";"2021MM12";"17591045";"   14267";"   18047";"   17633";"   13816";"    -410";"    -373";"17590672"
"350";"2021JJ00";"17475415";"  179441";"  170972";"  252528";"  145330";"    -410";"  115257";"17590672"
"351";"2022MM01";"17590672";"   14054";"   14429";"   19578";"   12737";"       0";"    6466";"17597138"
"352";"2022MM02";"17597138";"   12764";"   13245";"   23109";"   11255";"       0";"   11373";"17608511"
"353";"2022MM03";"17608511";"   13585";"   15449";"   46541";"   11946";"       0";"   32731";"17641242"
"354";"2022MM04";"17641242";"   12890";"   14570";"   46288";"   10891";"       0";"   33717";"17674959"
"355";"2022MM05";"17674959";"   14022";"   13484";"   32677";"   12407";"       0";"   20808";"17695767"
"356";"2022MM06";"17695767";"   14098";"   13048";"   29168";"   16106";"       0";"   14112";"17709879"
"357";"2022MM07";"17709879";"   14894";"   13655";"   29407";"   20820";"       0";"    9826";"17719705"
"358";"2022MM08";"17719705";"   15257";"   13378";"   48447";"   20559";"       0";"   29767";"17749472"
"359";"2022MM09";"17749472";"   15231";"   12759";"   47081";"   17560";"       0";"   31993";"17781465"
"360";"2022MM10";"17781465";"   14481";"   14676";"   30322";"   15226";"       0";"   14901";"17796366"
"361";"2022MM11";"17796366";"   13223";"   14043";"   28462";"   14113";"       0";"   13529";"17809895"
"362";"2022MM12";"17809895";"   13005";"   17376";"   22028";"   15690";"    -571";"    1396";"17811291"
"363";"2022JJ00";"17590672";"  167504";"  170112";"  403108";"  179310";"    -571";"  220619";"17811291"
"364";"2023MM01";"17811291";"   13176";"   16564";"   25700";"   16401";"";"    5911";"17817202"
"365";"2023MM02";"17817202";"   12158";"   13997";"   28419";"   13986";"";"   12594";"17829796"
"366";"2023MM03";"17829796";"   13669";"   16083";"   26318";"   14984";"";"    8920";"17838716"
"367";"2023MM04";"17838716";"   12813";"   13327";"   20920";"   13038";"";"    7368";"17846084"
"368";"2023MM05";"17846084";"   14238";"   13139";"   23165";"   13214";"";"   11050";"17857134"
"369";"2023MM06";"17857134";"   13927";"   13061";"   23675";"   15557";"";"    8984";"17866118"
"370";"2023MM07";"17866118";"   14803";"   12610";"   25218";"   20805";"";"    6606";"17872724"
"371";"2023MM08";"17872724";"   14745";"   12665";"   42223";"   19976";"";"   24327";"17897051"
"372";"2023MM09";"17897051";"   13867";"   12834";"   41251";"   17334";"";"   24950";"17922001"
"373";"2023MM10";"17922001";"   14085";"   14134";"   31507";"   15406";"";"   16052";"17938053"
"374";"2023MM11";"17938053";"   13396";"   14832";"   25250";"   14461";"";"    9353";"17947406"
